111111111111111111111
110E00000000000000111
100110111111001110111
101000000111100C00111
100011110111101110111
111011110111101110111
111P111100000000C0111
111111111111111111111