1111111111111111111111111
1000000000000000000000001
10000000E0000000000000001
1000000000000000000000001
100000111111000000C000001
1000000010000000000000001
1000000010000000000000001
1000000010000011100000001
1000000000000010000000001
10000P0000000010000000001
10000000000011100C0000001
1000000000000000000000001
1000000000C00000000000001
1100000000000000000000001
1111111111111111111111111