11111111111111111
1P0000000000000C1
11111111111111101
11111111111111101
10000000000001101
10111111111101101
101111111111011C1
101111000E1101101
10111100111101101
10111100000001101
10111111111111101
10111111111111101
1C0000000000000C1
11111111111111111