1111111111111111
1P011000100010E1
11001010C010C011
1110C01111111111
1111111111111111