11111111111111111111111111111111111111
1P011111111111111111111111111111111111
11C00000111111111111111111111111111111
111111100C0111111111111111111111111111
1111111111000C011111111111111111111111
111111111111110000000000000000000000E1
11111111111111111111111111111111111111