111111111111111111111111111111111111
1P0000000000000C000000000000000000C1
101111111100100C001111111111100000C1
101000000000100C000000000000000000C1
101110111111100C000000111000000000C1
100C100000C1100C000000001000000000E1
111111111111111111111111111111111111