1111111111111111111111111
1E00000000000000000000001
1010010100001000000010101
10100100100010000P0010101
10000000000000000000E0001
1111111111111111111111111