1111111111111111111111111
1P0000000000C000000000001
1010010100001000000010101
10100100100010000P0010101
100000000CC000000C00E00C1
1111111111111111111111111